XX__________
XX__________
_X_X_XSXX___
XX_X___XX___
____XX_XX___
XXXXX__XX___
XX___X______
XX__________
XX_X___XX___
____XX_XX___
XXXXX__XX___
XX___X______
XX__________
_X__________
_X_X_X_XX___
XX_X___XX___
____XX_XX___
XXXXX__XX___
XX___X______
XX__________
XX_X___XX___
___XX_XX____
XXXXX__XX___
XX___X______
XXXXX__XX___
XX___X______
XX__________
XX__________
_X_X_X_XX___
XX_X___XX___
____XX_XX___
XXXXX__XX___
XX___X______
XX__________
XX_X___XX___
_G_XX_XX____
XXXXX__XX___
XX___X______
