____X___X_____XXXX__XX_X_X__X_XXX__XX_
_____________S_______XXXXX___XXX__XXX_
__X_____XXX___XXXX_XX_X__X_X__X_X__X_X
__XX_____XX_XX___XXXX___XXX__XX_XX_X__
_____XXX____XXXX_____________XXXXX__X_
_X_X____X_X_XX__X_X_X__X_X__XXXX____X_
_____XXXX____________________XXXX_____
_____X___X_____XXXX__XX_X_X__X_XXX__XX
___X_________XXXXX______X_____X_XX____
_____XXXX______X________XXXXXX______XX
_____XXXXX__________XXXXX________XX__X
_____X___X_____XXXX__XX_X_X__X_XXX__XX
__XX______X_X__X_X_X_X_XXXX__X___X__XX
__G__X___X___________XX_X_X__X_XXX__XX
_X_X_XXXXXXXXXXXXX_________XXXX__X__X_
XX_X_X__________X___X_X__X__X_X_X__X__
_X_X_XX_XXX_____X___X____X__X__X___X_X
___X_____X_X_XX___X____X_X_X_X_X__X_XX
